3Base/5BMM	SD_Canonical
4Base/6BMM	SD_Canonical
AAA	OnlyA
AAAA	OnlyA
AAAAA	OnlyA
AAAAAA	OnlyA
AAAAAC	DoubleA
AAAAAT	DoubleA
AAAAC	DoubleA
AAAAT	DoubleA
AAAATA	DoubleA
AAAATT	Other
AAAC	DoubleA
AAAT	DoubleA
AAATA	DoubleA
AAATAA	DoubleA
AAATAT	DoubleA
AAATT	Other
AAATTA	Other
AAATTT	Other
AAC	DoubleA
AACA	DoubleA
AACAA	DoubleA
AACAC	DoubleA
AACAT	DoubleA
AACTA	DoubleA
AACTT	Other
AAG	DoubleA
AAGAA	DoubleA
AAGAT	DoubleA
AAGGA	Other
AAGGAG	Other
AAGTA	DoubleA
AAGTT	Other
AAT	DoubleA
AATA	DoubleA
AATAA	DoubleA
AATAAA	DoubleA
AATAAT	DoubleA
AATAC	DoubleA
AATAT	DoubleA
AATATA	DoubleA
AATATT	Other
AATT	Other
AATTA	Other
AATTAA	Other
AATTAT	Other
AATTT	Other
AATTTA	Other
AATTTT	Other
AATGA	DoubleA
ACA	Other
ACAC	Other
ACACA	Other
ACACAC	Other
ACC	Other
ACCC	Other
ACCCA	Other
ACCCC	Other
ACCCCC	Other
ACGCA	Other
ACT	Other
ACTCA	Other
ACTCC	Other
AGA	Other_GA
AGAAG	DoubleA
AGAAGA	DoubleA
AGAAGG	Other_GA
AGAAGT	DoubleA
AGAGA	Other_GA
AGAGG	Other_GA
AGAGGG	Other_GA
AGAGT	Other
AGATG	Other
AGCAG	Other
AGCGA	Other
AGCGG	Other
AGCGT	Other
AGCTG	Other
AGG	SD_Canonical
AGGA	SD_Canonical
AGGA/GGAG/GAGG	SD_Canonical
AGGAG	SD_Canonical
AGGAG/GGAGG	SD_Canonical
AGGAG(G)/GGAGG	SD_Canonical
AGGAGA	Other_GA
AGGAGG	SD_Canonical
AGGG	Other_GA
AGGGA	Other_GA
AGGGAG	Other_GA
AGGGG	Other_GA
AGGGGA	Other_GA
AGGGGG	Other_GA
AGGGGT	Other
AGGGT	Other
AGGGTG	Other
AGGT	Other
AGGTG	Other
AGGTGA	Other
AGGTGG	Other
AGGTGT	Other
AGTAG	Other
AGTGA	Other
AGTGG	Other
AGTGT	Other
AGTTG	Other
AGxAG	SD_Canonical
AGxAGG/AGGxGG	SD_Canonical
ATA	TATATA_3_6
ATAA	DoubleA
ATAAA	DoubleA
ATAAAA	DoubleA
ATAAAT	DoubleA
ATAAG	DoubleA
ATAAT	DoubleA
ATAATA	DoubleA
ATAC	Other
ATACT	Other
ATAT	TATATA_3_6
ATATA	TATATA_3_6
ATATAA	Other
ATATAG	Other
ATATAT	TATATA_3_6
ATATT	Other
ATATTA	Other
ATATTT	Other
ATCAA	Other
ATCAT	Other
ATCCT	Other
ATCTA	Other
ATCTT	Other
ATG	Other
ATGA	Other
ATGAA	Other
ATGAT	Other
ATGCT	Other
ATGTA	Other
ATGTT	Other
ATT	DoubleT
ATTA	DoubleT
ATTAA	Other
ATTAAT	Other
ATTACA	DoubleT
ATTAT	DoubleT
ATTATA	DoubleT
ATTATT	DoubleT
ATTCT	DoubleT
ATTT	DoubleT
ATTTA	DoubleT
ATTTAA	Other
ATTTAT	DoubleT
ATTTT	DoubleT
ATTTTA	DoubleT
ATTTTT	DoubleT
CAAAC	DoubleA
CAC	Other
CACA	Other
CACAC	Other
CACACA	Other
CAG	Other
CATAC	Other
CCA	Other
CCACC	Other
CCC	NoA
CCCC	NoA
CCCCC	NoA
CCCCCC	NoA
CCCCG	NoA
CCCG	NoA
CCCGC	NoA
CCCGCC	NoA
CCG	NoA
CCGC	NoA
CCGCC	NoA
CCGCGC	NoA
CCGCGG	NoA
CCGG	NoA
CCGGC	NoA
CCGGCC	NoA
CCGGCG	NoA
CCGGG	NoA
CCT	NoA
CCTCC	NoA
CCTCG	NoA
CCTGC	NoA
CGACG	Other
CGAGC	Other
CGC	NoA
CGCA	Other
CGCC	NoA
CGCCCG	NoA
CGCG	NoA
CGCGC	NoA
CGCGCG	NoA
CGCGG	NoA
CGG	NoA
CGGGC	NoA
CGGGG	NoA
CGTCG	NoA
CTA	Other
CTAG	Other
CTC	NoA
CTCT	NoA
CTGC	NoA
CTGTG	NoA
CTTCT	NoA
GAAGA	Other_GA
GAAGG	Other_GA
GAAGT	Other
GAC	Other
GACGG	Other
GAG	SD_Canonical
GAGG	SD_Canonical
GAGGA	SD_Canonical
GAGGG	Other_GA
GAGGGA	Other_GA
GAGGT	Other
GAGGTG	Other
GAT	Other
GATGG	Other
GATTA	Other
GCA	Other
GCACG	Other
GCAGC	Other
GCCCC	NoA
GCCCG	NoA
GCCGC	NoA
GCG	NoA
GCGC	NoA
GCGCC	NoA
GCGCG	NoA
GCGCGC	NoA
GCGCGG	NoA
GCGGC	NoA
GCTCG	NoA
GCTGC	NoA
GCTGCT	NoA
GCTTAG	Other
GGA	SD_Canonical
GGA/GAG/AGG	SD_Canonical
GGAAGG	Other_GA
GGAG	SD_Canonical
GGAG/GAGG	SD_Canonical
GGAGA	Other_GA
GGAGG	SD_Canonical
GGAGGA	SD_Canonical
GGAGGG	Other_GA
GGAGGT	Other
GGAGT	Other
GGATG	Other
GGC	NoA
GGCAG	Other
GGCGA	Other
GGCGG	NoA
GGCGGC	NoA
GGCGT	NoA
GGCTG	NoA
GGG	NoA
GGGA	Other_GA
GGGAG	Other_GA
GGGAGG	Other_GA
GGGCGC	NoA
GGGG	NoA
GGGGA	Other_GA
GGGGCG	NoA
GGGGG	NoA
GGGGGA	Other_GA
GGGGGG	NoA
GGGGGT	NoA
GGGGT	NoA
GGGGTG	NoA
GGGT	NoA
GGGTG	NoA
GGGTGA	Other
GGGTGG	NoA
GGGTGT	NoA
GGT	NoA
GGTAG	Other
GGTG	NoA
GGTGA	Other
GGTGG	NoA
GGTGGT	NoA
GGTGT	NoA
GGTTG	NoA
GGxGG	SD_Canonical
GTG	NoA
GTGA	Other
GTGAT	Other
GTGG	NoA
GTGGT	NoA
GTGGTG	NoA
GTT	NoA
GTTGAG	Other
None	None
TAA	SD_Bacteroidetes
TAAA	SD_Bacteroidetes
TAAAA	SD_Bacteroidetes
TAAAAA	SD_Bacteroidetes
TAAAAT	SD_Bacteroidetes
TAAAC	DoubleA
TAAAT	SD_Bacteroidetes
TAAATA	DoubleA
TAAATT	Other
TAAC	DoubleA
TAAG	DoubleA
TAAT	DoubleA
TAATA	DoubleA
TAATAA	DoubleA
TAATAT	DoubleA
TAATT	Other
TAATTA	Other
TAATTT	Other
TAC	Other
TACAA	DoubleA
TACAC	Other
TACAT	Other
TACT	Other
TACTA	Other
TACTT	DoubleT
TAG	Other
TAGAA	DoubleA
TAGAC	Other
TAGAT	Other
TAGTA	Other
TAGTT	DoubleT
TAT	TATATA_3_6
TATA	TATATA_3_6
TATAA	DoubleA
TATAAA	DoubleA
TATAAT	DoubleA
TATAC	Other
TATACT	Other
TATAT	TATATA_3_6
TATATA	TATATA_3_6
TATATT	DoubleT
TATTA	DoubleT
TATTAA	Other
TATTAT	DoubleT
TATTT	DoubleT
TATTTA	DoubleT
TATTTT	DoubleT
TCC	NoA
TCT	NoA
TCTC	NoA
TCTCG	NoA
TCTCT	NoA
TCTCTG	NoA
TGA	Other
TGAT	Other
TGATG	Other
TGCTGC	NoA
TGG	NoA
TGGT	NoA
TGGTG	NoA
TTA	DoubleT
TTAA	Other
TTAAA	Other
TTAAAA	Other
TTAAAT	Other
TTAAT	Other
TTAATT	Other
TTAT	DoubleT
TTATA	DoubleT
TTATAA	Other
TTATAT	DoubleT
TTATT	DoubleT
TTATTT	DoubleT
TTCAA	Other
TTCAT	DoubleT
TTCTA	DoubleT
TTCTT	DoubleT
TTG	DoubleT
TTGAA	Other
TTGAT	DoubleT
TTGTA	DoubleT
TTGTT	DoubleT
TTT	OnlyT
TTTA	DoubleT
TTTAA	Other
TTTAAA	Other
TTTAAT	Other
TTTAT	DoubleT
TTTATT	DoubleT
TTTT	OnlyT
TTTTA	DoubleT
TTTTAA	Other
TTTTAT	DoubleT
TTTTT	OnlyT
TTTTTA	DoubleT
TTTTTT	OnlyT
